{
  "dimension": {
    "height": 8,
    "width": 8
  },
  "legend": {
    "0": "empty",
    "1": "wall",
    "2": "box",
    "3": "bomb",
    "4": "user"
  },
  "map": [1,1,1,1,1,1,1,1,
          1,4,0,0,0,0,0,1,
          1,0,0,0,0,0,0,1,
          1,0,0,0,0,0,0,1,
          1,0,0,0,2,0,0,1,
          1,0,0,0,0,0,0,1,
          1,0,0,0,0,0,0,1,
          1,1,1,1,1,1,1,1]
}